005
Александровска	александровска	LOC	LOC_37
БНТ 2	бнт два	PRO	PRO_42
Белодробната болница	белодробен болница	LOC	LOC_40
Библия	библия	PRO	PRO_44
Бойко Борисов	бойко борисов	PER	PER_30
Борисов	борисов	PER	PER_30
България	българия	LOC	LOC_1
ВКП	вкп	ORG	ORG_48
ВМА	вма	ORG	ORG_39
Военномедицинска академия	военномедицински академия	ORG	ORG_34
Втора градска болница	втори градски болница	ORG	ORG_36
ДАНС	данс	ORG	ORG_46
Десислава Танева	десислава танева	PER	PER_32
Конституция	конституция	PRO	PRO_43
Красимир Вълчев	красимир вълчев	PER	PER_41
МВР	мвр	ORG	ORG_47
Министерството на вътрешните работи	министерство на вътрешен работа	ORG	ORG_35
Министерството на здравеопазването	министерство на здравеопазване	ORG	ORG_35
Националната референтна лаборатория	национален референтен лаборатория	ORG	ORG_33
Националния оперативен щаб	национален оперативен щаб	ORG	ORG_31
Пирогов	пирогов	LOC	LOC_38
Урсула фон дер Лайен	урсула фон дер лайен	PER	PER_45
