056
BioNTech	biontech	ORG	ORG_68
Ema	ema	ORG	ORG_83
FDA	fda	ORG	ORG_66
Pfizer	pfizer	ORG	ORG_67
Агенцията за контрол на храните и лекарствата	агенция за контрол на храна и лекарство	ORG	ORG_65
Агенцията за контрол на храните и лекарствата FDA	агенция за контрол на храна и лекарство fda	ORG	ORG_65
Американците	американец	PER	PER_64
Байдън	байдън	PER	PER_76
Бахрейн	бахрейн	LOC	LOC_80
Белият дом	бял дом	LOC	LOC_72
Великобритания	великобритания	LOC	LOC_6
Джо Байдън	джо байдън	PER	PER_76
Джонс Хопкинс	джонс хопкинс	ORG	ORG_75
Доналд Тръмп	доналд тръмп	PER	PER_70
ЕС	ес	ORG	ORG_5
Европейската агенция по лекарствата	европейски агенция по лекарство	ORG	ORG_82
Канада	канада	LOC	LOC_78
Мексико	мексико	LOC	LOC_79
Ню Йорк Таймс	ню йорк таймс	PRO	PRO_51
Пърл Харбър	пърл харбър	LOC	LOC_77
САЩ	сащ	LOC	LOC_69
Саудитска Арабия	саудитски арабия	LOC	LOC_81
Стивън Хан	стивън хан	PER	PER_73
Тръмп	тръмп	PER	PER_70
Туитър	туитър	PRO	PRO_71
Хан	хан	PER	PER_74
агенция за контрол на храните и лекарствата	агенция за контрол на храна и лекарство	ORG	ORG_65
