uk-10341
BioNTech	BioNTech	ORG	ORG_68
Moderna	Moderna	ORG	ORG_87
Pfizer	Pfizer	ORG	ORG_67
Pfizer-BioNTech	Pfizer-BioNTech	ORG	ORG_67
ЄС	ЄС	LOC	LOC_49
Європейська комісія	європейський комісія	ORG	ORG_129
Європейське агентство лікарських засобів	європейський агентство лікарський засіб	ORG	ORG_82
Європейського Союзу	європейський союз	ORG	ORG_5
Європейського агентства лікарських засобів	європейський агентство лікарський засіб	ORG	ORG_82
Європейської комісії	європейський комісія	ORG	ORG_1444
Європі	Європа	LOC	LOC_49
Євросоюзу	Євросоюз	LOC	LOC_49
Єнс Шпан	Єнс Шпан	PER	PER_682
Італії	Італія	LOC	LOC_50
Австрії	Австрія	LOC	LOC_19
Бельгії	Бельгія	LOC	LOC_1
Вашингтон	Вашингтон	LOC	LOC_183
Велика Британія	великий Британія	LOC	LOC_6
Великої Британії	великий Британія	LOC	LOC_6
Великій Британії	великий Британія	LOC	LOC_6
Німеччини	Німеччина	LOC	LOC_27
США	США	LOC	LOC_69
Сполучених Штатах	сполучений штат	LOC	LOC_69
ТБ	ТБ	ORG	ORG_1090
Урсула фон дер Ляєн	Урсула фон Дер Ляєн	PER	PER_45
Франції	Франція	LOC	LOC_20
